#####################################
#E      #       #                   #
# ##### # ##### # ##### ########### # 
# #   # # #   # # #   #         #   #
# # # # # # # # # # # ############# #
# # # # # # # # # # #               #
# # # # # # # # # # #############   #
# # # # # # # # # #             # # #
# # # # # # # # # ############# # # #
# # # # # # # # #             # # # #
# # # # # # # # ############# # # # #
# #   #   #   #               # # # #
# ########### #####  ###### #     ###
#          ##    ##  #      ## ##   #
############  ############   ###  # #
#                          #      S##
#####################################