#############################################################
#E    #     #       #       #       #         #         #   #
# ### # ### # ##### # ##### # ##### ### ##### # ##### # # ###
# #   # # # # #   # # #   # # #   #     #   # #     # # #   #
# # ### # # # # # # # # # # # # # ####### # # ##### # # ### #
# # #   # # # # # # # # # # # # #       # # #     # # #   # #
# # # ### # # # # # # # # # # # ####### # # ##### # # ### # #
# # # #   # # # # # # # # # # #         # #     # # #   # # #
# # # ### # # # # # # # # # # ####### # # ##### # # # ### # #
# # #   # # # # # # # # # # #       # # #     # # # #   # # #
# # ### # # # # # # # # # # ####### # # ##### # # # # # # # #
# # #   # # # # # #   # # #       # # #     # # # # # # # # #
# # # ### # # # # ##### # ####### # # ##### # # # # # # # # #
# # #   # # # # #   # #       # # # # #   # # # # # # # # # #
# # ### # # # # ### # ####### # # # # # # ### # # # # # # # #
# # #   # # # #   #        #  # # # # # #     # # # # ### # #
# # # ### # # ### ######## # ## # # # # ####### # # # # # # #
# # #   # # #   #      # # #    # # # #         # # # # # # #
# # ### # # ### ###### # # #### # # # ########### # # # # # #
# #   # # # #          # #      # # #             # # # # # #
# ### # # # ############ ######## # ############### # # # # #
# #   # # #              #      # #               # # # # # #
# # ### # ################ #### # ############### # # # # # #
# #   # #                # #  # #       #       # # # # #   #
# ### # ######## ######## ## # ####### # ##### # #  # #    ##
# #   #       # #        #  # #     # # #   # #  #  # # # # #
# # ######### # ########## # ##### # # ### # # # # ## # # # #
# #           #            #     # # #   # # # # #  # # # # #
# ########### ################# # # ### # # # # # # # # # # #
#           #               #   # #   # # # # # # # # # #   #
############# ############### # # ### # # # # # # # # # # # #
#           #               # # #   # # # # # # # # # # # # #
# ########### ############### # ### # # # # # # # # # # # ###
#           #               # #   # # # # # # # # # # # # # #
# ########### ############### ### # # # # # # # # # # #   # #
#                             # # # # # # # # # # # # # ### #
############################### # # # # # # # # # # # # # # #
#                               # # # # # # # # # # # # # # #
# ############################### # # # # # # # # # # # #   #
#                                 # # # # # # # # # # #   # #
# ####################################### # # # # # # # # # #
#                         #               # # # # # # # # # #
# ############################################# # # # # # # #
#                                               # # # # # # #
# ############################################### # # # # # #
#                                                 # # # # # #
# ################################################# # # ### #
#                                                   # # #   #
# ################################################### # ### #
#                                                     #    S#
#############################################################