###############################################################
#E    #     #       #                         #         #     #
# ### # ### # ##### # ##### # ##### ### ##### # ####### # ### #
# #   # # # # #   # # #   # #     #     #   # #       # #   # #
# # ### # # # # # # # # # # # # # ####### # # ####### # ### # #
# #     # # # # # # # # # # # # #       # # #       # #   # # #
# # # ### # # # # # # # # # # # ####### # # ####### # ### # # #
# # # #   # # # # # # # # # # #       # # #       # #   # # # #
# # # # ### # # # # # # # # # ####### # # ####### # ### # # # #
# # # # # # # # # # # # # # #       # # #       # #   # # # # #
# # # # # # # # # # # # # # ####### # # ####### # ### # # # # #
# # # # # # # # # # # # # #       # # #       # #   # # # # # #
# # # # # # # # # # # # # ####### # # ####### # ### # # # # # #
# # # # # # # # # # # # #       # # #       # #   # # # # # # #
# # # # # # # # # # # # ####### # # ####### # ### # # # # # # #
# #   #   # #   #   #         #   #       #             # # # #
# ####### # ######### ################### ########### ### # # #
#       # #           #                   #             #   # #
####### # ########### # ################### ############# ### #
#     # #           # # #                 #             #   # #
# ### # ########### # # # ############### ############# ### # #
# # # #           # # # #               #             #     # #
# # # ########### # # # ############### ############### ##### #
# # #           # # # #               #                 #     #
# # ########### # # # ############### ################# ##### #
# #           # # #                 #                 #     # #
# ########### # # # ############### ################# ##### # #
#           # # # #               #                 #     # # #
############# # # ############### ################# ##### # # #
#           # # #               #                 #     # # # #
# ########### # ############### ################# ##### # # # #
#             #                                   #     # #   #
################################################# ##### # #####
#                                                       #    S#
###############################################################