#######################
#E    #       #       #
##### # ##### # ## ## #
#   # # #   # # #   # #
# # # # # # # # # # # #
# # # # # # #   # # # #
# # # # # # # # # # # #
# #   #   #   #   # # #
# ########### ##### # #
#               #    S#
#######################