################
#E      #      #
# ##### # #### #
# #   # # #  # #
# # # # # ## # #
# # # # #    # #
# # # # ###### #
# # # #        #
# # # ######## #
# # #        #S#
################